WWWWWWWWWWWWWWWWWWWWWWWWWWW
WC                        W
W WWWWWWWWWWWWWWWWWWWWWWW W
W   W   W   WWWWW   W     W
W W   W   W   D   W   W W W
W WWWWWWWWWWWWWWWWWWWWWWW W
W                         W
WWWWWWWWWWWWWWWWWWWWWWWWWWW
